-----------------##############---------
-----------------#----------------------
-----------------#----------------------
----------------------------------------
----------------#################-------
----------------#---------------#-------
----------------#---------------#-------
----------------#---------------#-------
----------------#---X-------X---#-------
----------------#---------------#-------
----------------#---------------#-------
----------------#---------------#-------
----------------#---------------#-------
----------------#---------------#-------
----------------#######--########-------
----------------------------------------
----------------------------------------
----------------------------------------
----------------------------------------
-----------------###--------------------
-----------------###--------------------
-----------------###--------------------
----------------------------------------
----------------------------------------
----------------------------------------
----------------------------------------
----#--#--------------------------------
----#--#--------------------------------
----#--####--#############--############
----#--#--------#----------------------#
----#--#--------#----------------------#
----#--#-----X-----#-----------X-------#
----#--#-----------#-------------------#
----#--##############################--#
----#--##############################--#
----#-----------------------#########--#
----#-----------------------#########--#
----#####################--------------#
------------------------#--------------#
------------------------################
